NO ./assets/textures/lab_north.png
SO ./assets/textures/lab_south.png
WE ./assets/textures/lab_west.png
EA ./assets/textures/lab_east.png

F 30,20,40
C 0,255,255

        1111111111111111111111111
        1000000000110000000000001
        1011000001110000000000001
        1001000000000000000000001
111111111011000001110000000000001
100000000011000001110111111111111
10001111111111111100000010001
10001000000000000101010010001
11101101111110110100000010001
10000000000000001100000010001
10101010100000001101010010001
1000E00111010101111101111000111
10111111 1010101 101111010001
10000001 1000001 100000000001
11111111 1111111 111111111111
