NO ./assets/textures/lab_north.png
SO ./assets/textures/lab_south.png
WE ./assets/textures/lab_west.png
EA ./assets/textures/lab_east.png
P ./assets/textures/lab_door.png
O ./assets/textures/item_sprites/emerald.png

F 30,20,40
C 0,0,0

        1111111111111111111111111
        100D000001110000000000001
        10110000011100000I000000111111
        1011000000D00I0000I00000D00I01
11111111101100000111000I0I000000111101
100000000011000001110111111111111  101
1000111111111111110000I010001      111      
10001000D000D0000101010010001      
111011D111D11D11I100000010001
100I0000000000001100000010001
10111D111000000011I1010010001
100E0I01110101011111011D1000111
1D111111 10101011101111010001
100I0I01 100000D0D00000000001
11111111 1111111111111D111111
1111111111111111111111011111111111111111111111
100I000000000000000000000000000000000000000001
1111111111111111111111111111111111111111111111