NO ./assets/textures/lab_north.png
SO ./assets/textures/lab_south.png
WE ./assets/textures/lab_west.png
EA ./assets/textures/lab_east.png
P ./assets/textures/lab_door.png
O ./assets/textures/item_sprites/emerald.png

F 30,20,40
C 0,0,0

        1111111111111111111111111
        1000000000110000000000001
        1D110000011100000I0000001
        1001000000D00I0000I000001
11111111101100000111000I0I0000001
100000000011000001110111111111111
1000111111111111110000I010001
10001000D000D0000101010010001
111011D111D11D11010000I010001
100I0000000000001100000010001
10101010100000001101010010001
1000EI0111010101111101111000111
1D111111 1010101 101111010001
100I0I01 1000001 100000000001
11111111 1111111 111111111111
