                WE              ./cub3d_destroyer/wolftex/wood.png

             SO	                       ./cub3d_destroyer/wolftex/redbrick.png
                      F                 122,122,122
                                 NO ./cub3d_destroyer/wolftex/greystone.png
                                         S          ./cub3d_destroyer/wolftex/barrel.png
                                                                    R           1080                  720
                                                      EA                  ./cub3d_destroyer/wolftex/wood.png

                          C	                       255,200,160


        1111111111111111111111111
        1000000000110000000000001
        1011000001110000000000001
        1001000000000000000000001
111111111011000001110000000000001
100000000011000001110111111111111
10001111111111111100000010001
10001000000000000101010010001
11101101111110110100000010001
10000000000000001100000010001
10101010100000001101010010001
1000000111010101111101111000111
10111111 1010101 101111010001
10000001 1000001 100000000001
11111111 1111111 111111111111


111111
11
111